12 10
. . . . . . . . X . . .
~ ~ I . X I F . X . X .
. X I ~ . . F . . . X .
. . X . . . X X F ~ X .
. m F F . . . . F . . .
X . . . X X m ~ X ~ X X
~ ~ X . . . X . . . . .
. ~ X ~ . . . . X . . .
. . X m I m . X X ~ . .
. m m m . . . . . . . .
