[10,10]
(0,9)
(0,6) 
(5,0,2,1)
(6,1,1,3)
(1,1,1,8)
(2,2,2,1)
(3,0,1,1)
